NO textures/wood.png
SO textures/redbrick.png
WE textures/greystone.png
EA textures/colorstone.png

C 130,190,255
F 120,120,120

11111111
10000001
10S00001
10000001
11111001
10000001
11111111