NO textures/wood.png
SO textures/redbrick.png
WE textures/greystone.png
EA textures/colorstone.png

F 220,100,0
C 225,30,0

        1111111111111111111111111
        100000000F110000000000001
        10110000011100000000G0001
        1001000000D00000G00000001
11111111101100G001110000000000001
1F000000001100000111D111111111111
11110111111111011100000010001
1111D111111111D11101010010G01
11F0000011F1G10111000F0010001
100E00000000000011000000D0001
100000000000000G110101F010001
11F000F111F101011111011110G0111
1111F111 111G101 101111010001
11111111 1111111 111111111111